7,7,7,7,7,8,8,8,8,8,8,8,8,8,8,8
7,7,7,7,8,8,8,8,8,8,8,8,8,8,8,8
7,8,17,8,8,8,8,8,8,8,8,8,18,18,18,8
8,17,8,8,8,8,17,8,8,8,8,2,5,6,3,8
8,17,8,8,8,8,8,8,17,8,17,9,16,16,8,8
8,8,8,8,8,8,8,8,8,8,8,8,8,8,8,8
8,8,8,8,8,8,8,8,8,8,8,8,17,8,8,8
8,8,8,17,8,8,8,8,8,8,17,17,17,17,8,1
8,8,8,8,8,8,8,8,8,8,8,17,8,8,1,13
8,8,8,8,8,8,8,8,17,8,17,8,8,8,9,12
8,8,8,8,8,8,8,8,8,17,8,8,8,8,9,11
8,8,8,8,8,8,8,8,8,8,8,8,8,8,2,10
